border_size=1
usage=map

Xu          , Xu          , Xu          , Uh          , Uh          , Uh          , Uh          , Uu          , Uu          , Uu          , Uu          , Uu          , Uu          , Uu          , Uu          , Uh          , Uh          , Uh          , Uh          , Uh          , Uh          , Uu          
Xu          , Xu          , Uh          , Uh          , Uh          , Uh          , Uu          , Uu          , Uu          , Uu          , Uu          , Uu          , Uu          , Uu          , Uu          , Uu          , Uu          , Uu          , Uu          , Uh          , Uh          , Uu          
Uh          , Uh          , Uu          , Uu          , Uu          , Uu          , Uu          , Uu          , Uu          , Uu          , Ql          , Uu          , Ql          , Uu          , Uu          , Uu^Uf       , Uu^Uf       , Uu^Uf       , Uu          , Uu          , Uu          , Uu          
Uu          , Uu          , Uu          , Uu          , Uu^Uf       , Uu          , Uu          , Uu          , Ql^Bs\      , Ql          , Ql          , Ql          , Ql          , Ql          , Ql          , Uu          , Ql          , Uu^Uf       , Ql          , Uu          , Uu          , Uu          
Uu          , Uu          , Uu          , Uu          , Ql          , Uu          , Ql          , Ql          , Uu          , Uu          , Uu          , Uu          , Uu^Vud      , Uu          , Uu          , Ql          , Uu          , Ql          , Uu^Uf       , Ql          , Ql          , Ql          
Uu          , Uu          , Ql          , Ql          , Uu          , Ql          , Uu          , Uu          , Uu          , Uu          , Uu^Vud      , Uu          , Uu          , Uu          , Uu^Vud      , Uu          , Xu          , Uu          , Uu          , Uu          , Uu          , Uu          
Ql          , Ql          , Uu          , Uu          , Uu          , Uu          , Uu          , Uu^Vud      , Cud         , Cud         , Cud         , Cud         , Cud         , Uu          , Uu          , Uu          , Uu^Ii       , Xu          , Uu          , Uu          , Uu          , Uu          
Uu          , Uu          , Uu          , Uu          , Uu^Vud      , Uu          , Uu          , Uu          , 2 Kud       , Cud         , Cud         , 1 Kud       , Cud         , Cud         , Uu          , Uu          , Uu^Vud      , Uu          , Uu          , Uh          , Uh          , Uu          
Xu          , Xu          , Xu          , Uu          , Uu          , Uu          , Uu          , Uu          , Uu^Vud      , Cud         , Cud         , Cud         , Cud         , Cud         , Uu^Vud      , Uu          , Uu          , Uu^Vud      , Uu          , Uu          , Uu          , Uu          
Uu          , Uu^Uf       , Xu          , Uu          , Uu          , Uu^Vud      , Uu          , Uu          , Uu          , Uu          , Uu          , Uu^Vud      , Uu          , Uu          , Uu          , Uu          , Uu          , Uu          , Uu          , Uu          , Uu          , Uu          
Uu          , Uu^Uf       , Xu          , Uu          , Uu          , Uu          , Uu          , Uu          , Uu^Vud      , Uu          , Uu          , Uu          , Uu          , Uu          , Qlf         , Uu          , Qlf         , Uu          , Uu          , Uu          , Uu          , Uu          
Uu          , Uu          , Uu          , Uu          , Uu          , Uu^Uf       , Uu          , Uu          , Uu          , Uu          , Qlf         , Qlf         , Qlf         , Qlf         , Qlf         , Qlf         , Qlf         , Qlf         , Uu          , Uu^Uf       , Uu          , Uu          
Uu          , Uu          , Uu          , Uu          , Uu          , Uu          , Qlf         , Uu          , Qlf         , Qlf         , Qlf         , Qlf         , Qlf         , Qlf         , Uu          , Qlf         , Uu          , Uu          , Uu          , Uu          , Uu          , Uu          
Uu          , Uu          , Uu          , Uu          , Qlf         , Qlf         , Qlf         , Qlf         , Qlf         , Qlf         , Uu          , Uu          , Uu          , Uu          , Uu          , Uu          , Uu          , Uu          , Uu          , Uu          , Xu          , Xu          
Uu          , Uu          , Qlf         , Qlf         , Qlf         , Qlf         , Qlf         , Qlf         , Uu          , Uu          , Uu          , Uu          , Uu          , Uu          , Uu          , Uu          , Uu          , Uu          , Xu          , Xu          , Uu^Vud      , Uu          
Qlf         , Qlf         , Qlf         , Qlf         , Qlf         , Qlf         , Uu          , Uu          , Uu^Uf       , Uu          , Uu          , Uu          , Uu          , Uu          , Xu          , Uu          , Xu          , Xu          , Uu^Uf       , Uu^Vud      , Uu          , Uu          
Qlf         , Qlf         , Qlf         , Qlf         , Uu          , Uu          , Uu^Uf       , Uu^Uf       , Uu          , Uu^Uf       , Uu          , Uu          , Xu          , Xu          , Xu          , Xu          , Uh          , Uu          , Uu          , Uu          , Uu          , Uu          
Qlf         , Qlf         , Uu          , Uu          , Uu          , Uu          , Uu^Uf       , Uu          , Uu          , Uu          , Xu          , Xu          , Uu          , Xu          , Uu          , Uu          , Uu          , Uh          , Xu          , Uu          , Xu          , Xu          
Uu          , Uu          , Uu          , Uu          , Uu          , Uu          , Uu          , Uu          , Uu          , Xu          , Xu          , Xu          , Uu          , Uu          , Uu          , Ql          , Uu          , Uu          , Xu          , Xu          , Uu^Vud      , Uu          
Uu          , Uh          , Uh          , Uu          , Uu          , Uu          , Uu          , Uu          , Uu          , Xu          , Uu          , Uu          , Uu          , Uu          , Uu          , Ql          , Xu          , Xu          , Uu          , Uu          , Uu          , Uu          
Uu          , Uu          , Uu          , Uu          , Ql          , Uu          , Uu          , Uh          , Uu          , Xu          , Uu          , Uu^Uf       , Uu          , Uh          , Uu          , Uu          , Uu          , Uu^Uf       , Uu          , Uu          , Ql          , Uu          
Uu          , Uu          , Uu          , Uu          , Uu          , Uu          , Uu          , Uu          , Uu          , Uu          , Uu          , Uu          , Uu          , Uu          , Uu          , Uu          , Uu          , Uu          , Ql          , Ql          , Uu          , Uu          
