border_size=1
usage=map

Ds          , Ds          , Dd          , Ds          , Ds          , Ds          , Ds          , Ds          , Hd          , Hd          , Hd          , Hd          , Hd          , Hd          , Hd          , Md          , Md          , Md          , Md          , Hd          , Hd          , Hd          , Hd          , Ds          , Ds          , Ds          , Ds          , Ds          , Ds          , Ds          , Ds          , Ds          , Ds          , Ds          , Ds          , Ds          , Ds          
Ds          , Ds          , Dd          , Dd          , Dd          , Ds          , Ds          , Ds          , Ds          , Ds          , Ds          , Dd^Vdt      , Hd          , Hd          , Hd          , Hd          , Md          , Md          , Md          , Hd          , Hd          , Hd          , Hd          , Ds          , Ds          , Ds          , Ds          , Ds          , Dd          , Dd          , Dd          , Ds          , Ds          , Ds          , Ds          , Ds          , Ds          
Ds          , Dd          , Dd          , Dd          , Dd          , Ds          , Ds          , Ds          , Ds          , Ds          , Ds          , Rd          , Ds          , Hd          , Hd          , Hd          , Hd          , Md          , Md          , Md          , Hd          , Hd          , Hd          , Dd^Vda      , Rd          , Ds          , Ds          , Dd          , Dd          , Dd          , Ds          , Ds          , Ds          , Ds          , Ds          , Ds          , Ds          
Ds          , Ds          , Ds          , Dd          , Ds          , Dd          , Ds          , Ds          , Ds          , Ds          , Ds          , Rd          , Ds          , Ds          , Hd          , Hd          , Hd          , Md          , Md          , Md          , Md          , Hd          , Hd          , Ds          , Rd          , Ds          , Ds          , Dd          , Ds          , Ds          , Ds          , Dd^Vda      , Ds          , Ds          , Ds          , Ds          , Ds          
Ds          , Ds          , Ds          , Ds          , Ds          , Ds          , Ds          , Ds          , Ds          , Ds          , Ds          , Rd          , Ds          , Ds          , Ds          , Hd          , Hd          , Hd          , Md          , Md          , Md          , Hd          , Hd          , Ds          , Rd          , Rd          , Rd          , Rd          , Rd          , Ds          , Ds          , Rd          , Ds          , Ds          , Ds          , Ds          , Rd          
Ds          , Ds          , Ds          , Ds          , Ds          , Ds          , Ds          , Ds          , Ds          , Ds          , Ds          , Rd          , Ds          , Ds          , Ds          , Hd          , Hd          , Hd          , Hd          , Md          , Md          , Hd          , Hd          , Ds          , Rd          , Dd          , Dd          , Ds          , Ds          , Rd          , Ce          , Ce          , Ce          , Rd          , Rd          , Rd          , Ds          
Ds          , Ds          , Ds          , Ds          , Ce          , Ds          , Ds          , Ds          , Ds          , Ds          , Ds          , Rd          , Ds          , Ds          , Ds          , Ds          , Hd          , Hd          , Hd          , Md          , Md          , Hd          , Hd          , Ds          , Dd^Vda      , Dd          , Dd          , Dd          , Ds          , Ds          , Ce          , 2 Ke        , Ce          , Ds          , Ds          , Ds          , Ds          
Rd          , Ds          , Rd          , Ce          , 1 Ke        , Ce          , Rd          , Ds          , Rd          , Ds          , Rd          , Rd          , Ds          , Ds          , Ds          , Ds          , Ds          , Hd          , Hd          , Hd          , Md          , Md          , Hd          , Ds          , Ds          , Dd          , Dd          , Ds          , Rd          , Rd          , Ds          , Ce          , Ds          , Ds          , Ds          , Ds          , Ds          
Ds          , Rd          , Ds          , Ce          , Ce          , Ce          , Ds          , Rd          , Ds          , Rd          , Ds          , Rd          , Ds          , Ds          , Ds          , Ds          , Ds          , Hd          , Hd          , Hd          , Hd          , Md          , Hd          , Ds          , Ds          , Dd          , Ds          , Ds          , Rd          , Ds          , Ds          , Ds          , Ds          , Ds          , Ds          , Ds          , Ds          
Ds          , Ds          , Ds          , Ds          , Ds          , Ds          , Ds          , Ds          , Ds          , Ds          , Ds          , Rd          , Ds          , Ds          , Dd          , Ds          , Ds          , Ds          , Ds          , Hd          , Hd          , Md          , Hd          , Ds          , Ds          , Ds          , Ds          , Ds          , Rd          , Ds          , Dd          , Dd          , Ds          , Ds          , Ds          , Ds          , Ds          
Ds          , Ds          , Ds          , Ds          , Ds          , Ds          , Hd          , Ds          , Ds          , Ds          , Ds          , Rd          , Rd          , Ds          , Ds          , Ds          , Ds          , Ds          , Ds          , Ds          , Dd^Vdt      , Hd          , Ds          , Ds          , Ds          , Ds          , Ds          , Rd          , Ds          , Dd          , Dd          , Dd          , Dd          , Ds          , Ds          , Ds          , Ds          
Ds          , Ds          , Ds          , Ds          , Hd          , Hd          , Hd          , Hd          , Hd          , Hd          , Ds          , Ds          , Rd          , Ds          , Ds          , Ds          , Ds          , Ds          , Rd          , Rd          , Ds          , Hd          , Ds          , Ds          , Ds          , Ds          , Rd          , Rd          , Dd          , Dd          , Dd          , Dd          , Dd^Vda      , Ds          , Ds          , Ds          , Ds          
Ds          , Ds          , Ds          , Ds          , Hd          , Hd          , Md          , Hd          , Hd          , Hd          , Ds          , Ds          , Ds          , Rd          , Rd          , Ds          , Ds          , Rd          , Ds          , Ds          , Ds          , Hd          , Ds          , Ds          , Ds          , Ds          , Rd          , Ds          , Ds          , Dd          , Dd          , Ds          , Rd          , Rd          , Ds          , Ds          , Ds          
Ds          , Ds          , Ds          , Ds          , Hd          , Hd          , Hd          , Md          , Md          , Hd          , Hd          , Ds          , Ds          , Rd          , Ds          , Rd          , Rd          , Rd          , Ds          , Ds          , Ds          , Hd          , Ds          , Ds          , Rd          , Rd          , Ds          , Rd          , Rd          , Rd          , Rd          , Rd          , Ds          , Ds          , Ds          , Ds          , Ds          
Ds          , Ds          , Ds          , Dd          , Ds          , Hd          , Hd          , Hd          , Md          , Md          , Hd          , Hd          , Ds          , Rd          , Ds          , Ds          , Dd          , Rd          , Rd          , Ds          , Ds          , Ds          , Rd          , Rd          , Ds          , Ds          , Ds          , Ds          , Ds          , Ds          , Ds          , Ds          , Dd          , Ds          , Ds          , Ds          , Ds          
Ds          , Ds          , Ds          , Ds          , Ds          , Dd^Vdt      , Dd          , Hd          , Hd          , Md          , Md          , Hd          , Hd          , Rd          , Ds          , Dd          , Dd^Vdt      , Dd          , Ds          , Rd          , Rd          , Rd          , Rd          , Ds          , Ds          , Ds          , Ds          , Ds          , Ds          , Ds          , Dd          , Ds          , Ds          , Ds          , Ds          , Ds          , Hd          
Ds          , Ds          , Ds          , Ds          , Ds          , Ds          , Ds          , Hd          , Hd          , Md          , Md          , Hd          , Hd          , Dd^Vdt      , Ds          , Dd          , Dd          , Dd          , Ds          , Ds          , Ds          , Ds          , Rd          , Ds          , Dd          , Ds          , Ds          , Ds          , Ds          , Dd          , Dd          , Ds          , Ds          , Ds          , Ds          , Ds          , Hd          
Ds          , Ds          , Dd          , Ds          , Ds          , Ds          , Ds          , Dd          , Hd          , Md          , Md          , Hd          , Hd          , Hd          , Ds          , Ds          , Ds          , Ds          , Ds          , Ds          , Ds          , Ds          , Rd          , Dd          , Gs^Ft       , Ds          , Dd          , Ds          , Ds          , Dd          , Dd          , Ds          , Ds          , Ds          , Hd          , Hd          , Hd          
Ds          , Ds          , Dd          , Dd          , Ds          , Ds          , Ds          , Ds          , Ds          , Hd          , Hd          , Md          , Md          , Hd          , Hd          , Ds          , Ds          , Ds          , Ds          , Ds          , Ds          , Ds          , Dd^Vda      , Dd^Do       , Dd^Do       , Gs^Ft       , Ds          , Ds          , Ds          , Dd          , Ds          , Ds          , Ds          , Hd          , Hd          , Hd          , Md          
Ds          , Ds          , Dd          , Dd          , Dd          , Ds          , Ds          , Ds          , Ds          , Hd          , Hd          , Md          , Md          , Md          , Hd          , Ds          , Ds          , Ds          , Ds          , Ds          , Ds          , Ds          , Ds          , Gs^Ft       , Gs^Ft       , Ds          , Ds          , Ds          , Ds          , Dd          , Ds          , Ds          , Hd          , Hd          , Hd          , Md          , Md          
Ds          , Ds          , Ds          , Dd          , Ds          , Ds          , Ds          , Ds          , Ds          , Hd          , Hd          , Hd          , Md          , Md          , Hd          , Hd          , Ds          , Ds          , Ds          , Ds          , Ds          , Ds          , Ds          , Ds          , Ds          , Ds          , Ds          , Ds          , Ds          , Ds          , Ds          , Ds          , Hd          , Hd          , Md          , Md          , Md          
Ds          , Ds          , Ds          , Ds          , Ds          , Ds          , Ds          , Ds          , Ds          , Dd^Vdt      , Hd          , Hd          , Md          , Md          , Hd          , Hd          , Ds          , Ds          , Ds          , Dd          , Ds          , Ds          , Ds          , Ds          , Ds          , Ds          , Ds          , Ds          , Ds          , Ds          , Ds          , Ds          , Hd          , Hd          , Md          , Md          , Md          
