border_size=1
usage=map

Wo          , Wo          , Wo          , Wo          , Wo          , Wo          , Wo          , Wo          , Wo          , Wo          , Wo          , Wo          , Wo          , Wo          , Wo          , Wo          , Wo          , Wo          , Wo          , Wo          , Ww          , Wo          
Wo          , Wo          , Wo          , Wo          , Wo          , Wo          , Wo          , Wo          , Ww^Bw|      , Wo          , Ww          , Wo          , Ww          , Wo          , Wwf         , Wo          , Ww          , Ww          , Ww          , Ww          , Ds          , Ww          
Wo          , Wo          , Wo          , Wo          , Wo          , Wo          , Ww          , Ww          , Ww^Bw|      , Ww          , Ce          , Ce          , Ce          , Ww          , Ds          , Ww          , Ds          , Ds          , Ds          , Ds          , Gg          , Ds          
Ww          , Wo          , Wo          , Wo          , Ww^Vm       , Ww          , Ds          , Ds          , Gg          , Ds          , Ce          , 2 Ke        , Ce          , Ds          , Gg          , Ds          , Gg          , Gg          , Gg          , Gg          , Gg          , Gg          
Ds          , Ww          , Ww          , Ww          , Ds          , Ds          , Gg          , Gg          , Gg^Fet      , Gg          , Gg          , Ce          , Gg          , Gg          , Gs^Ft       , Gs^Ft       , Gs^Ft       , Gg          , Gg          , Gg          , Gg          , Gg          
Gg          , Ds          , Ds          , Ds          , Gg          , Gg          , Gg          , Gg          , Gg          , Gg          , Gg          , Rd          , Gg          , Gs^Ft       , Dd^Do       , Gs^Ft       , Gs^Ft       , Gg          , Gg          , Gg          , Gg          , Gg          
Gg          , Gg          , Gg          , Gg          , Gs^Ft       , Gs^Ft       , Gs^Ft       , Gg^Vc       , Gg          , Gg          , Gg          , Rd          , Gg          , Gs^Ft       , Gs^Ft       , Gs^Ft       , Gs^Ft       , Gg          , Gg          , Gg^Fet      , Gg          , Gg          
Gg          , Gg          , Gs^Ft       , Gs^Ft       , Gs^Ft       , Gs^Ft       , Gs^Ft       , Gs^Ft       , Gg          , Gg          , Gg          , Rd          , Gg          , Gg          , Gg          , Gs^Ft       , Gg          , Gg          , Gg          , Gg          , Gg          , Gg          
Gg          , Gs^Ft       , Gs^Ft       , Dd^Do       , Gs^Ft       , Gs^Ft       , Gs^Ft       , Gs^Ft       , Gg          , Gg          , Gg          , Rd          , Gg          , Gg          , Gg          , Gg          , Gg          , Gg          , Gg          , Gg          , Gg          , Gg          
Gg          , Gs^Ft       , Gs^Ft       , Gs^Ft       , Gs^Ft       , Gs^Ft       , Gg          , Gg          , Gg          , Gg          , Gg          , Rd          , Gg          , Gg^Fet      , Gg          , Gg          , Gg          , Gg^Vc       , Gs^Ft       , Gg          , Gg          , Gg          
Gg          , Gg          , Gg          , Gg          , Gg          , Gg          , Gg          , Gg^Fet      , Gg          , Gg          , Gg          , Rd          , Gg          , Gg          , Gg          , Gg          , Gs^Ft       , Gs^Ft       , Gs^Ft       , Gs^Ft       , Gg          , Gg          
Gg          , Gg          , Gg          , Gg          , Gg          , Gg          , Gg          , Gg          , Gg          , Gg          , Gg          , Rd          , Rd          , Gg          , Gg          , Gs^Ft       , Gs^Ft       , Gs^Ft       , Gs^Ft       , Gs^Ft       , Gg          , Gg          
Gg          , Gg          , Gs^Ft       , Gs^Ft       , Gs^Ft       , Gg          , Gs^Ft       , Gs^Ft       , Gs^Ft       , Gg          , Gg          , Rd          , Rd          , Gg          , Gg          , Gs^Ft       , Gs^Ft       , Dd^Do       , Gs^Ft       , Gs^Ft       , Gg          , Gg          
Gg          , Gg          , Gs^Ft       , Gs^Ft       , Gs^Ft       , Gs^Ft       , Gs^Ft       , Gs^Ft       , Gs^Ft       , Gg          , Gg          , Gg          , Rd          , Gg          , Gg          , Gs^Ft       , Gs^Ft       , Gs^Ft       , Gs^Ft       , Gs^Ft       , Gs^Ft       , Gg          
Gg          , Gg          , Gg          , Gs^Ft       , Gs^Ft       , Gs^Ft       , Gg          , Gs^Ft       , Gg          , Ds          , Gg          , Gg          , Rd          , Gg          , Gg          , Gs^Ft       , Gs^Ft       , Gs^Ft       , Gs^Ft       , Gs^Ft       , Gs^Ft       , Gg          
Gg          , Ds          , Gg^Vc       , Gg          , Gg          , Ds          , Gg          , Gg          , Gg          , Gg          , Gg          , Gg          , Rd          , Gg          , Gg          , Gs^Ft       , Gs^Ft       , Gs^Ft       , Gg          , Gs^Ft       , Gg          , Gg          
Gg          , Gg          , Gg          , Gg          , Ds          , Gg          , Ds          , Ds          , Ds          , Ds          , Gg          , Gg          , Rd          , Gg          , Ds          , Gg          , Ds          , Gg          , Ds          , Gg          , Ds          , Ds          
Ds          , Ds          , Ds          , Ds          , Ds          , Ds          , Dd          , Ds          , Ds          , Ds          , Ds          , Ds          , Rd          , Ds          , Ds          , Ds          , Ds          , Ds          , Ds          , Ds          , Dd          , Ds          
Ds          , Ds          , Ds          , Dd          , Ds          , Ds          , Hd          , Ds          , Ds          , Ds          , Ce          , Ce          , Dd^Vda      , Ce          , Ce          , Ce          , Ce          , Ds          , Ds          , Ds          , Hd          , Ds          
Ds          , Ds          , Dd          , Ds          , Dd^Dc       , Hd          , Ds          , Hd          , Ds          , Ds          , 1 Ke        , Dd^Vdt      , Rp          , Dd^Vda      , Ds          , Ds          , Dd^Do       , Ce          , Ds          , Ds          , Ds          , Ds          
Ds          , Ds          , Ds          , Ds          , Ds          , Ds          , Ds          , Dd          , Ds          , Ds          , Ce          , Dd^Vdt      , Ce          , Dd^Vdt      , Ce          , Ds          , Ce          , Ce          , Ds          , Dd          , Ds          , Ds          
Ds          , Ds          , Ds          , Ds          , Ds          , Ds          , Ds          , Ds          , Ds          , Ds          , Ds          , Ce          , Ds          , Ce          , Ds          , Ce          , Ds          , Ds          , Ds          , Ds          , Ds          , Ds          
