border_size=1
usage=map

Ds          , Ds          , Ds          , Ds          , Ds          , Ds          , Ds          , Ds          , Hd          , Md          , Md          , Md^Xm       , Md^Xm       , Md          , Md          , Hd          , Hd          , Ds          , Ds          , Ds          , Ds          , Ds          , Ds          , Ds          , Dd          , Ds          , Ds          , Ds          , Hd          , Md          , Md          , Hd          , Ds          , Ds          , Ds          , Ds          , Ds          , Ds          , Ds          , Ds          , Ds          , Ds          
Ds          , Ds          , Ds          , Ds          , Ds          , Ds          , Ds          , Ds          , Hd          , Hd          , Md          , Md^Xm       , Md          , Md          , Hd          , Hd          , Hd          , Ds          , Ds          , Ds          , Ds          , Ds          , Ds          , Dd          , Dd          , Ds          , Ds          , Ds          , Hd          , Md          , Md          , Hd          , Hd          , Ds          , Ds          , Ds          , Ds          , Ds          , Ds          , Ds          , Ds          , Ds          
Ds          , Ds          , Ds          , Ds          , Ds          , Ds          , Ds          , Ds          , Hd          , Hd          , Hd          , Md          , Dd^Vdt      , Hd          , Md          , Hd          , Hd          , Dd^Vdt      , Ds          , Ds          , Ds          , Ds          , Ds          , Dd          , Dd          , Dd          , Ds          , Ds          , Ds          , Hd          , Hd          , Md          , Md          , Dd^Dc       , Ds          , Ds          , Ds          , Dd^Vdt      , Ds          , Ds          , Ds          , Ds          
Ds          , Ds          , Ds          , Ds          , Ds          , Ds          , Ds          , Ds          , Hd          , Hd          , Hd          , Hd          , Md          , Md          , Md          , Hd          , Hd          , Hd          , Hd          , Ds          , Ds          , Ds          , Ds          , Dd          , Dd          , Ds          , Ds          , Ds          , Ds          , Hd          , Hd          , Md          , Md          , Hd          , Hd          , Ds          , Ds          , Ds          , Ce          , Ds          , Ds          , Ds          
Ds          , Ds          , Ce          , Ce          , Ce          , Ds          , Ds          , Ds          , Dd^Vdt      , Hd          , Hd          , Hd          , Md          , Md          , Md          , Md          , Hd          , Hd          , Hd          , Hd          , Ds          , Ds          , Ds          , Dd          , Dd          , Ds          , Ds          , Ds          , Ds          , Ds          , Dd          , Hd          , Hd          , Md          , Hd          , Ds          , Ds          , Ce          , 3 Ke        , Ce          , Ds          , Ds          
Ds          , Ds          , Ce          , 1 Ke        , Ce          , Ds          , Ds          , Ds          , Ds          , Hd          , Hd          , Hd          , Hd          , Md          , Md          , Md          , Hd          , Hd          , Hd          , Hd          , Ds          , Ds          , Ds          , Dd          , Dd          , Dd          , Dd          , Ds          , Ds          , Dd          , Dd          , Dd          , Hd          , Md          , Hd          , Ds          , Ds          , Ce          , Ce          , Ce          , Ds          , Ds          
Ds          , Ds          , Ds          , Ce          , Ds          , Ds          , Ds          , Ds          , Ds          , Hd          , Hd          , Hd          , Hd          , Md          , Md          , Md          , Md          , Hd          , Hd          , Hd          , Ds          , Ds          , Ds          , Dd          , Dd          , Dd          , Dd          , Ds          , Ds          , Dd          , Dd          , Dd          , Hd          , Md          , Hd          , Hd          , Ds          , Ds          , Ds          , Ds          , Ds          , Ds          
Ds          , Ds          , Ds          , Ds          , Ds          , Ds          , Ds          , Ds          , Ds          , Ds          , Hd          , Hd          , Hd          , Hd          , Md          , Md          , Md          , Hd          , Hd          , Hd          , Ds          , Ds          , Dd          , Dd          , Dd          , Dd          , Dd          , Ds          , Ds          , Dd          , Dd          , Dd          , Hd          , Md          , Hd          , Ds          , Ds          , Ds          , Ds          , Ds          , Ds          , Ds          
Xu          , Xu          , Xu          , Ds          , Ds          , Ds          , Ds          , Ds          , Ds          , Ds          , Hd          , Hd          , Hd          , Hd          , Md          , Md          , Md          , Hd          , Hd          , Hd          , Ds          , Ds          , Dd          , Dd          , Dd          , Dd          , Ds          , Ds          , Ds          , Ds          , Ds          , Ds          , Hd          , Md          , Hd          , Hd          , Ds          , Ds          , Dd^Vdt      , Ds          , Ds          , Ds          
Uu          , Uu^Vu       , Xu          , Ds          , Ds          , Ds          , Ds          , Ds          , Ds          , Ds          , Ds          , Hd          , Hd          , Hd          , Md          , Md          , Md          , Hd          , Hd          , Hd          , Ds          , Ds          , Ds          , Dd          , Ds          , Ds          , Dd^Vdt      , Ds          , Ds          , Ds          , Ds          , Ds          , Hd          , Hd          , Hd          , Hd          , Ds          , Ds          , Ds          , Ds          , Ds          , Ds          
Uu          , Xu          , Xu          , Ds          , Ds          , Ds          , Ds          , Ds          , Ds          , Ds          , Ds          , Hd          , Hd          , Hd          , Hd          , Md          , Md          , Md          , Hd          , Hd          , Ds          , Ds          , Ds          , Ds          , Ds          , Ds          , Ds          , Ds          , Ds          , Ds          , Ds          , Ds          , Ds          , Hd          , Ds          , Ds          , Ds          , Ds          , Dd          , Dd          , Dd          , Ds          
Uu          , Xu          , Ds          , Ds          , Ds          , Ds          , Ds          , Ds          , Ds          , Ds          , Ds          , Ds          , Dd^Vdt      , Hd          , Hd          , Hd          , Hd          , Md          , Hd          , Hd          , Ds          , Ds          , Hd          , Ds          , Ds          , Ds          , Ds          , Ds          , Ds          , Ds          , Ds          , Ds          , Ds          , Ds          , Ds          , Ds          , Dd          , Dd          , Dd          , Dd          , Dd          , Ds          
Uu          , Xu          , Xu          , Ds          , Ds          , Ds          , Ds          , Ds          , Ds          , Ds          , Ds          , Ds          , Ds          , Hd          , Hd          , Hd          , Hd          , Hd          , Hd          , Hd          , Ds          , Ds          , Hd          , Hd          , Ds          , Ds          , Ds          , Ds          , Dd          , Ds          , Ds          , Ds          , Ds          , Ds          , Dd          , Dd          , Dd          , Dd          , Dd          , Dd          , Ds          , Ds          
Uu          , Uu          , Xu          , Ds          , Ds          , Ds          , Ds          , Ds          , Ds          , Ds          , Ds          , Ds          , Ds          , Hd          , Hd          , Hd          , Hd          , Hd          , Hd          , Hd          , Ds          , Ds          , Ds          , Hd          , Hd          , Ds          , Ds          , Ds          , Dd          , Dd          , Ds          , Ds          , Ds          , Ds          , Dd          , Dd          , Dd          , Dd          , Dd^Vdt      , Ds          , Ds          , Ds          
Uu          , Uu          , Xu          , Xu          , Ds          , Ds          , Ds          , Ds          , Ds          , Ds          , Ds          , Ds          , Ds          , Hd          , Hd          , Hd          , Hd          , Hd          , Hd          , Hd          , Ds          , Ds          , Ds          , Hd          , Hd          , Ds          , Ds          , Ds          , Dd          , Dd          , Ds          , Ds          , Ds          , Ds          , Ds          , Dd          , Ds          , Ds          , Ds          , Ds          , Ds          , Ds          
Uu          , Uu          , Xu          , Ds          , Ds          , Ds          , Ds          , Ds          , Ds          , Ds          , Ds          , Ds          , Ds          , Hd          , Hd          , Hd          , Hd          , Hd          , Ds          , Ds          , Ds          , Ds          , Ds          , Hd          , Hd          , Ds          , Ds          , Ds          , Dd          , Dd          , Dd          , Ds          , Ds          , Ds          , Ds          , Ds          , Ds          , Ds          , Ds          , Ds          , Ds          , Ds          
Uu          , Uu          , Xu          , Ds          , Ds          , Ds          , Ds          , Ds          , Ds          , Ds          , Ds          , Ds          , Ds          , Ds          , Ds          , Hd          , Ds          , Ds          , Ds          , Ds          , Ds          , Ds          , Ds          , Hd          , Hd          , Ds          , Ds          , Ds          , Dd          , Dd          , Dd          , Dd          , Ds          , Ds          , Ds          , Ds          , Ds          , Ds          , Ds          , Ds          , Ds          , Ds          
Uu          , Uu          , Xu          , Ds          , Ds          , Ds          , Ds          , Ds          , Ds          , Ds          , Ds          , Ds          , Ds          , Ds          , Dd^Do       , Ds          , Ds          , Ds          , Ds          , Ds          , Ds          , Ds          , Ds          , Hd          , Dd^Dc       , Ds          , Ds          , Ds          , Ds          , Dd          , Dd          , Dd          , Dd          , Ds          , Ds          , Ds          , Ds          , Ds          , Ds          , Ds          , Ds          , Ds          
Uu          , Uu          , Uu^Vu       , Xu          , Xu          , Ds          , Ds          , Ds          , Ds          , Ds          , Ds          , Ds          , Ds          , Ds          , Ds          , Ds          , Ds          , Dd^Vda      , Ds          , Ds          , Ds          , Ds          , Hd          , Hd          , Ds          , Ds          , Ds          , Ds          , Ds          , Dd          , Dd          , Dd          , Ds          , Ds          , Ds          , Ds          , Ce          , Ds          , Ds          , Ds          , Ds          , Ds          
Uu          , Uu          , Uu          , Uu          , Uu          , Xu          , Xu          , Ds          , Ds          , Ds          , Ds          , Ds          , Ds          , Ds          , Ds          , Ds          , Ds          , Ds          , Ds          , Ds          , Hd          , Hd          , Hd          , Hd          , Ds          , Ds          , Ds          , Ds          , Ds          , Dd          , Dd          , Dd          , Ds          , Ds          , Ce          , Ce          , 2 Ke        , Ce          , Ds          , Ds          , Ds          , Ds          
Uu          , Uu          , Uu          , Uu          , Uu          , Uu          , Uu          , Uu          , Uu          , Ds          , Ds          , Ds          , Ds          , Ds          , Ds          , Ds          , Ds          , Ds          , Ds          , Hd          , Hd          , Hd          , Ds          , Ds          , Ds          , Ds          , Ds          , Ds          , Dd          , Dd          , Dd          , Ds          , Ds          , Ds          , Ce          , Ce          , Ce          , Ce          , Ds          , Ds          , Ds          , Ds          
Ds          , Uh          , Uh          , Uu          , Uu          , Uu          , Uu          , Uu          , Uu          , Uu          , Uu          , Ds          , Ds          , Ds          , Ds          , Ds          , Ds          , Ds          , Ds          , Hd          , Ds          , Ds          , Ds          , Ds          , Ds          , Ds          , Dd^Vda      , Ds          , Dd          , Dd          , Ds          , Ds          , Ds          , Ds          , Ds          , Ce          , Ds          , Ds          , Ds          , Ds          , Ds          , Ds          
Ds          , Uh          , Uh          , Uh          , Uu          , Uu          , Uh          , Uu          , Uu          , Uu          , Uu          , Uu          , Xu          , Ds          , Ds          , Ds          , Ds          , Ds          , Ds          , Ds          , Ds          , Ds          , Ds          , Ds          , Ds          , Ds          , Ds          , Ds          , Ds          , Dd          , Ds          , Ds          , Ds          , Ds          , Ds          , Ds          , Ds          , Ds          , Ds          , Ds          , Ds          , Ds          
Ds          , Uh          , Uh          , Uh          , Uu          , Uu^Uf       , Xu          , Uh          , Uu^Uf       , Uu          , Uu          , Uh          , Uh          , Xu          , Xu          , Ds          , Ds          , Ds          , Ds          , Ds          , Ds          , Ds          , Ds          , Ds          , Ds          , Ds          , Ds          , Ds          , Ds          , Ds          , Ds          , Ds          , Ds          , Ds          , Ds          , Ds          , Ds          , Ds          , Ds          , Ds          , Ds          , Ds          
Ww          , Ds          , Ds          , Uh          , Uu          , Uh          , Uh          , Xu          , Xu          , Uu          , Uu          , Uu          , Uh          , Uu^Uf       , Uu^Uf       , Xu          , Xu          , Ds          , Ds          , Ds          , Ds          , Ds          , Ds          , Ds          , Ds          , Ds          , Ds          , Ds          , Ds          , Ds          , Ds          , Ds          , Ds          , Ds          , Ds          , Ds          , Ds          , Dd^Vdt      , Ds          , Ds          , Ds          , Ds          
Wo          , Ww          , Ww          , Ds          , Ds          , Uu          , Uh          , Uh          , Xu          , Uu^Vud      , Uu          , Uu          , Uu          , Uu          , Uu          , Uu          , Uu          , Xu          , Xu          , Ds          , Ds          , Ds          , Ds          , Ds          , Uu^Ii       , Ds          , Uu^Ii       , Ds          , Xu          , Ds          , Ds          , Ds          , Ds          , Ds          , Ds          , Ds          , Ds          , Ds          , Ds          , Ds          , Ds          , Ds          
Wo          , Wo          , Wo          , Ww          , Ww          , Ds          , Ds          , Uu          , Uu          , Xu          , Uu          , Uu          , Uu          , Uu          , Xu          , Uu          , Uu          , Uu          , Uh          , Xu          , Xu          , Uu^Ii       , Uu^Ii       , Uu^Ii       , Uu^Vud      , Xu          , Xu          , Xu          , Uu          , Uu          , Uu          , Ds          , Ds          , Ds          , Ds          , Uu^Ii       , Uu^Ii       , Uu^Ii       , Uu^Ii       , Ds          , Ds          , Ds          
Wo          , Wo          , Wo          , Wo          , Ww^Vm       , Ww          , Ww          , Ds          , Uu          , Xu          , Uu          , Uu          , Uu          , Xu          , Uu^Vud      , Xu          , Xu          , Uu          , Uu          , Uu          , Uu          , Xu          , Xu          , Xu          , Xu          , Xu          , Uu          , Uu          , Uu          , Uu          , Uu          , Uu          , Uu          , Uu          , Uu          , Ds          , Xu          , Uu^Ii       , Xu          , Xu          , Uu^Ii       , Uu^Ii       
Wo          , Wo          , Wo          , Wo          , Wo          , Wo          , Ww          , Ds          , Ds          , Xu          , Xu          , Uu          , Uu          , Xu          , Xu          , Uu          , Uu          , Xu          , Xu          , Uu          , Uu          , Uu          , Uu          , Uu^Uf       , Uu          , Uu^Vu       , Uu          , Uu          , Uh          , Uh          , Uh          , Uh          , Uu          , Uu          , Uu^Vu       , Xu          , Uh          , Uu          , Uu          , Uu          , Uu          , Uu          
Wo          , Wo          , Wo          , Wo          , Wo          , Wo          , Wo          , Ww          , Xu          , Xu          , Uu^Uf       , Uu          , Uu          , Xu          , Xu          , Uu          , Uu          , Uu^Uf       , Xu          , Xu          , Xu          , Uu          , Uu          , Uu          , Uu          , Uu          , Uu          , Uu          , Uu          , Uu          , Uu          , Uu          , Uu          , Uu          , Uu          , Xu          , Xu          , Uh          , Uh          , Ql          , Uu          , Uu          
Wo          , Wo          , Wo          , Wo          , Wo          , Wo          , Wo          , Ww          , Xu          , Xu          , Uu^Uf       , Uu          , Uu          , Xu          , Uu          , Uu          , Uh          , Uu^Uf       , Uu          , Uu^Vud      , Uu          , Xu          , Xu          , Uh          , Uh          , Uu          , Uu^Uf       , Uu          , Uu          , Uu          , Uu          , Uu          , Uu^Uf       , Uu^Uf       , Uu^Uf       , Xu          , Xu          , Uh          , Uh          , Uu          , Uu          , Uu          
Wo          , Wo          , Wo          , Wo          , Wo          , Wo          , Wo          , Ww          , Xu          , Xu          , Ql          , Ql          , Uu          , Uu          , Uu          , Uu          , Ql          , Ql          , Ql          , Ql          , Ql          , Uu          , Xu          , Xu          , Xu          , Xu          , Xu          , Xu          , Xu          , Uu^Vu       , Xu          , Xu          , Xu          , Xu          , Xu          , Ql          , Xu          , Uh          , Uu          , Uu          , Uu          , Uu          
